{
	"name" : "Floating Temple",
	"author" : "hu9o",

	"tileset" : "spelunky",
	"background" : "spelunky.png",

	"tilemap" :
	[
		". . . . . . . . . . . . . . . . . . . . . . . . . t . . . . . . . . . . . . . . . . . . . . . . . . ",
		". . . . . . . . . . . . . . . . . . . . . . . . . j . . . . . . . . . . . . . . . . . . . . . . . . ",
		". . . . . . . . . . . . . . . . . . . . . . . . . . . . . . . . . . . . . . . . . . . . . . . . . . ",
		". . . . . . . . . . . . . . . . . . . . . . . . . . . . . . . . . . . . . . . . . . . . . . . . . . ",
		". . . . . . . . . . . . . . . . . . . . . . . . . . . . . . . . . . . . . . . . . . . . . . . . . . ",
		". . . . . . . . . . . . . . . . . . . . . . . . . . . . . . . . . . . . . . . . . . . . . . . . . . ",
		". . . . . . . . . . . . . . . . . . . . . . . . . . . . . . . . . . . . . . . . . . . . . . . . . . ",
		". . . . . . . . . . . . . . . . . . . . . . . . . . . . . . . . . . . . . . . . . . . . . . . . . . ",
		". . . . . . . . . . . . . . . . . . . . . . . . . . . . . . . . . . . . . . . . . . . . . . . . . . ",
		". . . . . . . . . . . . . . . . . . . . . . . . . . . . . . . . . . . . . . . . . . . . . . . . . . ",
		". . . . . . . . . . . . . . . . . . . . . . . . . . . . . . . . . . . . . . . . . . . . . . . . . . ",
		". . . . . . . . . . . . . . . . . . . . . . . . . . . . . . . . . . . . . . . . . . . . . . . . . . ",
		". . . . . . . . . . . . . . . . . . . . . . . . . . . . . . . . . . . . . . . . . . . . . . . . . . ",
		". . . . . . . . . . . . . . . . . . . . . . . . . . . . . . . . . . . . . . . . . . . . . . . . . . ",
		". . . . . . . . . . . . . . . . . . . . . . . . . . . . . . . . . . . . . . . . . . . . . . . . . . ",
		". . . . . . . . . . . . . . . . . . . . . . . . . . . . . . . . . . . . . . . . . . . . . . . . . . ",
		". . . . . . . . . . . . . . . . . . . . . . . . . . . . . . . . . . . . . . . . . . . . . . . . . . ",
		". . . . . . . . . . . . . . . . . . . . . . . . . . . . . . . . . . . . . . . . . . . . . . . . . . ",
		". . . . . . . . . . . . . . . . . . . . . . . . . . . . . . . . . . . . . . . . . . . . . . . . . . ",
		". . . . . . . . . . . . . . . . . . . . . . . .@. . . . . . . . . . . . . . . . . . . . . . . . . . ",
		". . . . . . . . . . . . . ( Z ) . . . . . . . . B B . . . . . . . . . . . . . . . . . . . . . . . . ",
		". . . . . . . . . . . . . . & . . .@. . . . . . . . . . . .@. . . ( Z ) . . . . . . . . . . . . . . ",
		". . . . . . . . . . . . . . & . . . j j . . . t . . t . . . j j . . & . . . . . . . . . . . . . . . ",
		". . . . . . . . . . . . . . & . . . . . i . . t . j t j . i . . .@. & n@. . . . . . . . . . . . . . ",
		". . . . . . . . . . . . . n@& . . . . . l . j t j j t j . l . . . j j j . . . . . . . . . . . . . . ",
		". . . . . . . . . . . . . j j j . . . . t E t t t t t t E t . . . . j . . . . . . . . . . . . . . . ",
		". . . . . . . . . . . . . j j . . . . j t H t . . . . t H t . . . . s . . . . . . . . . . . . . . . ",
		". . . . . . . . . . . . . s . . . . j j . H t . N . . t H j j .@. . s . . . . . . . . . . . . . . . ",
		". . . . . . . . . . . . . s . . T . . . . H t . B B . t H . . . T . . . . . . . . . . . . . . . . . ",
		". . . . . . . . . . . . . . .@. K@. i j .@H t . . . N t H .@i . K . . . . . . . . . . . . . . . . . ",
		". . . . . . . . . . . . . . . t t t j j t t t t . . t t t j j t t t . . . . . . . . . . . . . . . . ",
		"~ ~ ~ ~ ~ ~ ~ ~ ~ ~ ~ ~ ~ ~ ~ ~ t j j t t t j j ~ ~ t t j j t t t ~ ~ ~ ~ ~ ~ ~ ~ ~ ~ ~ ~ ~ ~ ~ ~ ~ ",
		"- - - - - - - - - - - - - - - - - j - j j - j j - - j j - j j - -s- - - - - - - - - - - - - - - - - ",
		"- - - - - - - - - - - - - - - - - s-- - -s- j - - - -sj - -s- - -s- - - - - - - - - - - - - - - - - ",
		"j j j - j j j j j j j j j - - - - s-- - -s- - - - - - - - -s- - - - - - - - j j j j j j j j j j j j ",
		"j j j - j j j j j j j j j j - - -n- - - - - - - -nj - - - - - j - - - - - j j j j j j j j j j j j j ",
		"j j j - j j j j j j j j j j j - j j j j - - j - j j - j - j j j j -nj j j j j j j j j j j j j j j j ",
		"j j j j j j j j j j j j j j j j j j j j j j j j j j j j j j j j j j j j j j j j j j j j j j j j j j "
	],

	"entities" :
	{

	},

	"keys" :
	{
		"m-light-enabled" : true,
		"m-light-min" : 16,
		"m-light-disp-void" : 32,
		"m-light-disp-solid" : 255,
		"m-light-disp-water" : 48,
		"m-light-sun" : 255
	}

}
